,,,,,,,,,,,,,,,,,,,,,,,,,,,,,,,,,,,,,,,,,,,,,,,,,,,,,,,,,,,,,
##,,,,,,,,,,,,,,,,,,,,,,,,,,,,,,,,,,,,,,,,,,,,,,,,,,,,,,,,,,=
.#,,,,,,,,,,,,,,,,,,,,,,,,,,,,,,,,,,,,,,,,,,,,,,,,,,,,,,,,,,=
.#,,,,,,,,,,,,,,,,,,,,,,,,,,,,,,,,,,,,,,,,,,,,,,,,,,,,,,,,,,=
.#,,,,,,,,,,,,,,,,,,,,,,,,,,,,,,,,,,,,,,,,,,,,,,,,,,,,,,,,'==
.#,,,=====,,,,,,,,,,,,,,,,,,,,,===,,,,,,,,,,,,,===,,,,,,,'''=
##'''='''''''===,,,,,,,,,,===,,,,,,,====,,,,,,,,,,,,,===''''=
..'''='''''''''''''====''''''''''''''''''''==''''''''==''''==
!#====''''''''''''''''''''''''''''''''''''''''''''''''='''''=
.#'''''''''''''''''''''''''''''''''''''''''''''''''''===''''=
.#'''''''''''''''''''''''''''''''''''''''''''''''''''==''''==
.#'''''''''''''''''''''''''''''''''''''''''''''''''''=='''''=
.#''''''''''''''''=='==''==''==''==''==''==''=''''''====''''=
.#'S'B''''''=====''''''''''''==''''''''''''''==''''''''''''==
===============================''''''''''''''========'''=====
'''''''''''''''''''''''''''''''''''''''''''''''''''''''''''''
